name,ox,oy,next,twin
a1,0,1,a3,a2
a2,3,1,a4,a1
a3,3,1,a5,a6
a4,0,1,a6,a5
a5,2,3,a1,a4
a6,2,3,a2,a3
,,,,
fa1,a2,,,
