half edge,ox,oy,endx,endy,next,prev,twin
e11,0,4,2,4,e42,e31,e12
e12,2,4,0,4,e32,e41,e11
e21,2,2,1,1,e22,e42,e22
e22,1,1,2,2,e31,e21,e21
e31,2,2,0,4,e11,e22,e32
e32,0,4,2,2,e41,e12,e31
e41,2,2,2,4,e12,e32,e42
e42,2,4,2,2,e21,e11,e41